****************************************
***** * * ** *       * **      *********
*****   * ** * ***** * *  ** * *********
******* * ** * ***** * ***** * *********
*****       ** ***** *       * *       *
*     ** *** *       * * ***** * *******
* * **** *** **** **** *       * *******
* * *           * *  * * *******    ****
* * * * * ******* * ** * *       **  ***
* * *****       * * ** * ******* *** ***
* *       ******  * ** *****     * * * *
* ** **** ******* * **     * * *   * * *
*       *       * * * *** ** * *** * * *
*** ****  **** ** * * *** **       * * *
***  ***                  ** ** ** * * *
**** *** *********** ** * ** **      * *
**** ***        * *  ** * ** ** ****** *
****   * ** ***** * ****               *
****** * **             *** **** ***** *
*           ***   *****                *
***** * * ** *       * **      *********
*****   * ** * ***** * *  ** * *********
******* * ** * ***** * ***** * *********
*****       ** ***** *       * *       *
*     ** *** *       * * ***** * *******
* * **** *** **** **** *       * *******
* * *           * *  * * *******    ****
* * * * * ******* * ** * *       **  ***
* * *****       * * ** * ******* *** ***
* *       ******  * ** *****     * * * *
* ** **** ******* * **     * * *   * * *
*       *       * * * *** ** * *** * * *
*** ****  **** ** * * *** **       * * *
***  ***                  ** ** ** * * *
**** *** *********** ** * ** **      * *
**** ***        * *  ** * ** ** ****** *
****   * ** ***** * ****               *
****** * **             *** **** ***** *
*           ***   *****                *
****************************************
