**************************************************************************************************************
*    *******   ***********************************                *****            ***************************
* ** *******                     ***************** *************        ******* *                            *
* ** ******* * ***************** * *************** ************** ** ********** * ******* ****************** *
*                                                                                                            *
**** ************************* ********************************************    **************** ************ *
**** *************************                                              ** **************** ************ *
****          **************** ****** ************************************* **                               *
************* **************** ******           **             ************ ** ***************************** *
************* ***        **    ***************  **** ******** ************* ** ***************************** *
*****         *** *****     **                                                                               *
***** *********** ***** ******   ************************** *** ** **************** *** **  * * ***** ********
*****     ***     ***** ******      ******************      *** ******************* *** **  *   ***** ********
********* ***           *********   ******    ******** ******** *****             * *** *************     ****
****      ************* ******      ******    ******            ***** ***********   *** ***************** ****
**** ****************** ******   ********* ********* ********** ** ** ****************   **************** ****
*                                                                                                            *
*** ***** ******** ** ** * ******* ** ******* *** ***************   ************************ **** ***** ** ***
*   ***** *   **** ** ** * ********** ******* ***    *********     ************************* **** ***        *
* *******     **** ** ** *     ******         *** ** **     ** **                   ******** **** ***   **** *
* ******** *******  *    *****  ***************** ** **     *   * ** ************** ******** ****      ***   *
*          ******* ****  ****** ******            ** ** ** *  *  ***                         ******  ***** ***
*** ****** ******* ****     ***        ************* *       *** **********************************  *     ***
*   ****** *******  ***  *********************************   *** **********************************  * *******
***                                                                                                          *
***** ************ * * ***** **************** **  ** ************* *****     ***************** *******     ***
****************        ****               ** **            ****** *******     **    ****      *********** ***
****************************************** ** ** ***************** ******* **        **** **************** ***
************** ****************** ******** ** ** *************************  ** ********** **************     *
*                                                                                                         ** *
**** **** ******************* *** ****** * ******* ***** * ****  ****************** ****** ***** ******** ** *
****   ** ****                 ** *******           ****    ***          **********   ****       *****    ** *
****** ** **** ************** *** *****************************  ******************** **** *********** **    *
*                                                                                                         ** *
**************************************************************************************************************
